#################..##################
#...................................#
#...................................#
#...................................#
#...................................#
#...................................#
#...................................#
#...................................#
#...................................#
#...................................#
##########################.....######